###############
# *#    #    3#
# ## ##2# #####
#     < # #8#
####^####2  #
#@      #####
##########
     #>  #
   ###   #
   #v    ###
   #  3    #
   #  #  v #
   #> ### ######
#####         v#
#>  #^### #### #
###   #     <#8#
  ##    #    ###
   ###########
