#####################
#@                  #
#######   ######### #
  #v  #   #      #* #
  ##  #   #      ####
  #       ##
  #        #
  #     #  #
  #  ^###  #
###       ###
#     =   < #
# ######### #
#          ^#
#############
Exit: 56 45 52 59  47 4F 4F 44
