#########
#      *#
# #######
#@    #1#
##### # #
#     # #
# ##### #
#1#     #
### #####
  #^#
  ###
