############
# @   |   *#
# ##########
#-    #
##### #
    # #
    #^#
    ###
Exit: gj
