 ######### #####
 #       # #v  #
 # #    <# # # #
 # #     # #5# #
 # #>    ##### #
## #1   <#  3# #
#@^#     # ### #
####     #     #
# 3# #####  ####
#  #    2#  #5#
#  ####### ^# #
#       <#### #
######## #    #
# v#2    # ####
#  # > v #    #
#  #     #### #
#  #  ^< #    #
# ##    <# ####
# 1#     #   *#
###############
Exit: VAEIRY GÜD
