###      #########
#2###    #     v#
# #1# #### #### #
# # # #      1# #####
# # # #    #       <#
# # ###>  ^# # ######
#v#  <###### # #
#@    #*     #2#
################
Exit: vory goud
