#######
#*    #
#     #
#@   ^#
#######
