    ###########
    #         #
##### #######v###
#@    |    *#   #
##### ####### # #
# ^   #<      #-#
###   ####### ###
#=#   #     # #
#     #     #^#
#######     ###
Exit: [38;5;1mG[38;5;2mo[38;5;3mo[38;5;4md [38;5;5mj[38;5;6mo[38;5;7mb[38;5;8m!
