   ############
   #          #
#### ######## ####
#@    |    *#-   #
##### ############
#=    #
#     #
#     #
#     #
#######
