#####
#@  #
#   #
#   #
#  1#
#####

         #####
         #  1#
         #   #
         #   #
         #*  #
         #####
